NO ./textures/wall64-no.xpm
SO ./textures/wall64-so.xpm
WE ./textures/wall64-we.xpm
EA ./textures/wall64-ea.xpm

F 220,100,0
C 0,30,100

1111111111111111111111111
1100000000010001000000001
1100000000000000000000001
1100000000000000000000001
1000000000000000100000001
1000000000000W00000000001
1000000000000000100000001
1100000000000000000000001
1000000000010001000000001
1111111111111111111111111
