NO ./textures/wall64-no.xpm
SO ./textures/wall64-so.xpm
WE ./textures/wall64-we.xpm
EA ./textures/wall64-ea.xpm

F 26,85,87
C 0,167,170

111111
100011
100001
10N001
100001
111111