SO ./textures/wall64-so.xpm
WE ./textures/wall64-we.xpm
EA ./textures/wall64-ea.xpm
NO ./textures/wall64-no.xpm

F 220,0,0
C 220,250,0

1111111111
1E1
11111111111111