NO ./textures/wall64-no.xpm
SO ./textures/wall64-so.xpm
WE ./textures/wall64-we.xpm
EA ./textures/wall64-ea.xpm
F 26,85,87
C 0,167,170

   11
111E01
100001
 1111
