SO ./textures/wall64-so.xpm
WE ./textures/wall64-we.xpm
EA ./textures/wall64-ea.xpm
NO ./textures/wall64-no.xpm

F 220,0,0
C 220,250,0






                    1
        11111111111  111111111111
   111111S000000001  10000000001111111
   1    1011000101111100100000001    
   1    1001000000001101 10000011
 1111111101100000111  1 10000001
10001000001100000111111111111111
11110111111111011100000010001
   111       111 111111111111 
   111       111 111111111111
1111011111111101110101101001
11000001101010111001010100011
11000000000011111100000000001
1000000100001111110000000001111111
10000000000000011101010010001
1100000111010101 111011110111
11110111 1110101 101111010001
1111111     1 1   1    1 111
1101111 111111111111
11111111111111111111111111111
              
