NO    ./textures/wall64-no.xpm
SO    ./textures/wall64-so.xpm
WE ./textures/wall64-we.xpm
EA  ./textures/wall64-ea.xpm
F 26,85,87
C 0,167,170

                                     1          111
                                    101         1S1
                                   10001        101
                                  1000001       101
11111111111              111111111000000111111110001
10000001000111111111111110000000000000000000000000001
110000010000000000000000000000000000000000000000000001
1111100100111111111111111000000000000000000000000000001
    1001001              1000000000000000000000000000001
11111001001              10000000000000000000000000000001
10000000001              10000000000000000000000000000001
11111111111              10000000000000000000000000000001
                         10000000000000000000000000000001
                         11111111111111111111111111111111
