















NO ./textures/wall64-no.xpm





SO                           ./textures/wall64-so.xpm


WE ./textures/wall64-we.xpm
EA                                                                      ./textures/wall64-ea.xpm


















F 026,00000000085,0000000000000000000000000000000000000000000000000000000000000000000000000000000000000000000000000000000000000000000000000000000000000000000000000000000000000000000000000000000000000000000000000000





C                                                                  0,167,170
11111
10001
10E01
10001
11111
